                                       X
                                       X
                 1               AAAAA X
                XXX    CWXXXX   XXXXXXXXXXXXXXXX
                       CWXXXX        
 XXX                $  CWXXXX   C C C C C C C C          CC
XXXXX     C            CWXXXX  C C C C C C C C C               G
XXXXX A  XXX  E     E  CWXXXXXXXXXXXXXXXXXXXXXXX     WXXBBBBXXXXX
XXXXXXXXXXXXXXXXXXXXXXXXXXXXXXXXXXXXXXX    1         WXXXXXXXXXXX
XXXXXXXXXXXXXXXXXXXXXXXXXXXXXXXXXXXXXXX   AAA S      WXXXXXXXXXXX
XXXXXXXXXXXXXXXXXXXXXXXXXXXXXXXXXXXXXXXXXXXXXXXXXXXXXXXXXXXXXXXXX