
                        WXXXX   XXXXXXX 
                A       WXXXX       XXX 
               XXX      WXXXX       XXX
 XXXX     C             WXXXX   G   XXX 
 XXXX    XXX            WXXXXXXXXXXXXXX 
 XXXXXXXXXXXXXXXXXXXXXXXXXXXXXXXXXXXXXX 
 XXXXXXXXXXXXXXXXXXXXXXXXXXXXXXXXXXXXXX